12
3,5,5,5,5,5,5,5,7,7,7,6
9,6,1,7,7,7,7,7,15,15,15,14
2,9,6,9,15,15,15,15,15,15,15,14
11,6,9,6,9,15,15,15,15,15,15,14
11,15,6,9,6,9,5,15,15,15,15,14
11,15,15,6,9,7,7,15,15,15,15,14
11,15,15,11,6,9,13,15,15,15,15,14
11,15,15,15,15,7,7,15,15,15,15,14
11,15,15,15,15,15,15,15,15,15,15,14
11,15,15,15,15,15,15,15,15,15,15,14
11,15,15,15,15,15,15,15,15,15,15,14
9,13,13,13,13,13,13,13,13,13,13,12
